[
  {
    "platforms": [
      3,3,3,6,2,1,2,1,2,6,2,1,2,1,4,3,3,2,1,2,3,4,1,2,3,6,6,2,1,2,2,1,2,6,2,3,2,4,1,2,2,6,2,1,1,3,3,6,1,1
    ],
    "coins": [
      4,5,6,8,11,12,13,15,18,20,21,23,26,28,31,34,36,37,40,41,42,43,44,46,48,50,52,53,55,56
    ]
  },
  {
    "platforms": [
      3,3,3,3,3,6,2,5,5,2,2,3,3,2,1,4,4,3,2,2,4,2,1,2,1,6,3,3,4,1,1,3,3,2,2,6,2,1,1,2,2,3,2,4,2,3,2,1,1,1
    ],
    "coins": [
      3,5,7,12,13,14,16,17,21,22,24,25,27,28,29,30,31,33,36,37,38,40,41,44,45,46,49,50,52,55
    ]
  },
  {
    "platforms": [
      3,3,3,2,2,1,1,3,3,6,2,3,3,3,2,2,1,1,1,2,3,3,2,2,3,3,2,4,2,6,2,2,4,4,3,3,2,4,2,1,3,3,4,4,6,3,2,4,2,1
    ],
    "coins": [
      2,4,5,6,7,9,11,13,15,17,18,19,20,22,23,25,26,28,32,33,34,37,40,42,45,47,50,52,54,56
    ]
  },
  {
    "platforms": [
      3,3,3,3,2,1,1,2,3,3,2,4,2,6,4,1,1,2,4,3,2,2,1,3,6,2,4,1,3,6,1,4,2,2,1,2,1,3,3,2,3,4,1,2,2,6,2,2,3,2
    ],
    "coins": [
      3,4,5,6,7,8,10,11,15,18,21,23,24,26,29,31,35,37,41,42,43,44,46,47,50,51,52,55,57,58
    ]
  }
]